card|cards|a card|
Curse|Curses|a Curse|
Copper|Coppers|a Copper|
Silver|Silvers|a Silver|
Gold|Golds|a Gold|
Estate|Estates|an Estate|
Duchy|Duchies|a Duchy|
Province|Provinces|a Province|
Artisan|Artisans|an Artisan|
Bandit|Bandits|a Bandit|
Bureaucrat|Bureaucrats|a Bureaucrat|
Cellar|Cellars|a Cellar|
Chapel|Chapels|a Chapel|
Council Room|Council Rooms|a Council Room|
Festival|Festivals|a Festival|
Gardens|Gardens|a Gardens|
Harbinger|Harbingers|a Harbinger|
Laboratory|Laboratories|a Laboratory|
Library|Libraries|a Library|
Market|Markets|a Market|
Merchant|Merchants|a Merchant|
Militia|Militias|a Militia|
Mine|Mines|a Mine|
Moat|Moats|a Moat|
Moneylender|Moneylenders|a Moneylender|
Poacher|Poachers|a Poacher|
Remodel|Remodels|a Remodel|
Sentry|Sentries|a Sentry|
Smithy|Smithies|a Smithy|
Throne Room|Throne Rooms|a Throne Room|
Vassal|Vassals|a Vassal|
Village|Villages|a Village|
Witch|Witches|a Witch|
Workshop|Workshops|a Workshop|
Courtyard|Courtyards|a Courtyard|
Conspirator|Conspirators|a Conspirator|
Courtier|Courtiers|a Courtier|
Baron|Barons|a Baron|
Bridge|Bridges|a Bridge|
Diplomat|Diplomats|a Diplomat|
Duke|Dukes|a Duke|
Harem|Harems|a Harem|
Nobles|Nobles|a Nobles|
Ironworks|Ironworks|an Ironworks|
Lurker|Lurkers|a Lurker|
Masquerade|Masquerades|a Masquerade|
Mill|Mills|a Mill|
Mining Village|Mining Villages|a Mining Village|
Minion|Minions|a Minion|
Patrol|Patrols|a Patrol|
Pawn|Pawns|a Pawn|
Replace|Replaces|a Replace|
Secret Passage|Secret Passages|a Secret Passage|
Shanty Town|Shanty Towns|a Shanty Town|
Steward|Stewards|a Steward|
Swindler|Swindlers|a Swindler|
Torturer|Torturers|a Torturer|
Trading Post|Trading Posts|a Trading Post|
Upgrade|Upgrades|an Upgrade|
Wishing Well|Wishing Wells|a Wishing Well|
Ambassador|Ambassadors|an Ambassador|
Bazaar|Bazaars|a Bazaar|
Caravan|Caravans|a Caravan|
Cutpurse|Cutpurses|a Cutpurse|
Embargo|Embargos|an Embargo|
Explorer|Explorers|an Explorer|
Fishing Village|Fishing Villages|a Fishing Village|
Ghost Ship|Ghost Ships|a Ghost Ship|
Haven|Havens|a Haven|
Island|Islands|an Island|
Lighthouse|Lighthouses|a Lighthouse|
Lookout|Lookouts|a Lookout|
Merchant Ship|Merchant Ships|a Merchant Ship|
Native Village|Native Villages|a Native Village|
Navigator|Navigators|a Navigator|
Outpost|Outposts|an Outpost|
Pearl Diver|Pearl Divers|a Pearl Diver|
Pirate Ship|Pirate Ships|a Pirate Ship|
Salvager|Salvagers|a Salvager|
Sea Hag|Sea Hags|a Sea Hag|
Smugglers|Smugglers|a Smugglers|
Tactician|Tacticians|a Tactician|
Treasure Map|Treasure Maps|a Treasure Map|
Treasury|Treasuries|a Treasury|
Warehouse|Warehouses|a Warehouse|
Wharf|Wharves|a Wharf|
Alchemist|Alchemists|an Alchemist|
Apothecary|Apothecaries|an Apothecary|
Apprentice|Apprentices|an Apprentice|
Familiar|Familiars|a Familiar|
Golem|Golems|a Golem|
Herbalist|Herbalists|a Herbalist|
Philosopher's Stone|Philosopher's Stones|a Philosopher's Stone|
Possession|Possessions|a Possession|
Potion|Potions|a Potion|
Scrying Pool|Scrying Pools|a Scrying Pool|
Transmute|Transmutes|a Transmute|
University|Universities|a University|
Vineyard|Vineyards|a Vineyard|
Bank|Banks|a Bank|
Bishop|Bishops|a Bishop|
Colony|Colonies|a Colony|
Contraband|Contrabands|a Contraband|
Counting House|Counting Houses|a Counting House|
City|Cities|a City|
Expand|Expands|an Expand|
Forge|Forges|a Forge|
Grand Market|Grand Markets|a Grand Market|
Goons|Goons|a Goons|
Hoard|Hoards|a Hoard|
King's Court|King's Courts|a King's Court|
Loan|Loans|a Loan|
Mint|Mints|a Mint|
Monument|Monuments|a Monument|
Mountebank|Mountebanks|a Mountebank|
Peddler|Peddlers|a Peddler|
Platinum|Platina|a Platinum|
Quarry|Quarries|a Quarry|
Rabble|Rabbles|a Rabble|
Royal Seal|Royal Seals|a Royal Seal|
Talisman|Talismans|a Talisman|
Trade Route|Trade Routes|a Trade Route|
Vault|Vaults|a Vault|
Venture|Ventures|a Venture|
Watchtower|Watchtowers|a Watchtower|
Worker's Village|Worker's Villages|a Worker's Village|
Prize|Prize|Prize|
Bag of Gold|Bags of Gold|a Bag of Gold|
Diadem|Diadems|a Diadem|
Fairgrounds|Fairgrounds|a Fairgrounds|
Farming Village|Farming Villages|a Farming Village|
Followers|Followers|a Followers|
Fortune Teller|Fortune Tellers|a Fortune Teller|
Hamlet|Hamlets|a Hamlet|
Harvest|Harvests|a Harvest|
Horse Traders|Horse Traders|a Horse Traders|
Horn of Plenty|Horns of Plenty|a Horn of Plenty|
Hunting Party|Hunting Parties|a Hunting Party|
Jester|Jesters|a Jester|
Menagerie|Menageries|a Menagerie|
Princess|Princesses|a Princess|
Remake|Remakes|a Remake|
Tournament|Tournaments|a Tournament|
Trusty Steed|Trusty Steeds|a Trusty Steed|
Young Witch|Young Witches|a Young Witch|
Border Village|Border Villages|a Border Village|
Cache|Caches|a Cache|
Cartographer|Cartographers|a Cartographer|
Crossroads|Crossroads|a Crossroads|
Develop|Develops|a Develop|
Duchess|Duchesses|a Duchess|
Embassy|Embassies|an Embassy|
Farmland|Farmlands|a Farmland|
Fool's Gold|Fool's Golds|a Fool's Gold|
Haggler|Hagglers|a Haggler|
Highway|Highways|a Highway|
Ill-Gotten Gains|Ill-Gotten Gains|an Ill-Gotten Gains|
Inn|Inns|an Inn|
Jack of All Trades|Jacks of All Trades|a Jack of All Trades|
Mandarin|Mandarins|a Mandarin|
Noble Brigand|Noble Brigands|a Noble Brigand|
Nomad Camp|Nomad Camps|a Nomad Camp|
Oasis|Oases|an Oasis|
Oracle|Oracles|an Oracle|
Margrave|Margraves|a Margrave|
Scheme|Schemes|a Scheme|
Silk Road|Silk Roads|a Silk Road|
Spice Merchant|Spice Merchants|a Spice Merchant|
Stables|Stables|a Stables|
Trader|Traders|a Trader|
Tunnel|Tunnels|a Tunnel|
Ruins|Ruins|a Ruins|
Knights|Knights|a Knights|
Abandoned Mine|Abandoned Mines|an Abandoned Mine|
Altar|Altars|an Altar|
Armory|Armories|an Armory|
Band of Misfits|Bands of Misfits|a Band of Misfits|
Bandit Camp|Bandit Camps|a Bandit Camp|
Beggar|Beggars|a Beggar|
Catacombs|Catacombs|a Catacombs|
Count|Counts|a Count|
Counterfeit|Counterfeits|a Counterfeit|
Cultist|Cultists|a Cultist|
Dame Anna|Dame Annas|Dame Anna|
Dame Josephine|Dame Josephines|Dame Josephine|
Dame Molly|Dame Mollies|Dame Molly|
Dame Natalie|Dame Natalies|Dame Natalie|
Dame Sylvia|Dame Sylvias|Dame Sylvia|
Death Cart|Death Carts|a Death Cart|
Feodum|Feoda|a Feodum|
Forager|Foragers|a Forager|
Fortress|Fortresses|a Fortress|
Graverobber|Graverobbers|a Graverobber|
Hermit|Hermits|a Hermit|
Hovel|Hovels|a Hovel|
Hunting Grounds|Hunting Grounds|a Hunting Grounds|
Ironmonger|Ironmongers|an Ironmonger|
Junk Dealer|Junk Dealers|a Junk Dealer|
Madman|Madmen|a Madman|
Market Square|Market Squares|a Market Square|
Marauder|Marauders|a Marauder|
Mercenary|Mercenaries|a Mercenary|
Mystic|Mystics|a Mystic|
Necropolis|Necropolis|a Necropolis|
Overgrown Estate|Overgrown Estates|an Overgrown Estate|
Pillage|Pillages|a Pillage|
Poor House|Poor Houses|a Poor House|
Procession|Processions|a Procession|
Rats|Rats|a Rats|
Rebuild|Rebuilds|a Rebuild|
Rogue|Rogues|a Rogue|
Ruined Library|Ruined Libraries|a Ruined Library|
Ruined Market|Ruined Markets|a Ruined Market|
Ruined Village|Ruined Villages|a Ruined Village|
Sage|Sages|a Sage|
Scavenger|Scavengers|a Scavenger|
Sir Bailey|Sir Baileys|Sir Bailey|
Sir Destry|Sir Destries|Sir Destry|
Sir Martin|Sir Martins|Sir Martin|
Sir Michael|Sir Michaels|Sir Michael|
Sir Vander|Sir Vanders|Sir Vander|
Spoils|Spoils|a Spoils|
Storeroom|Storerooms|a Storeroom|
Squire|Squires|a Squire|
Survivors|Survivors|a Survivors|
Urchin|Urchins|an Urchin|
Vagrant|Vagrants|a Vagrant|
Wandering Minstrel|Wandering Minstrels|a Wandering Minstrel|
Advisor|Advisors|an Advisor|
Baker|Bakers|a Baker|
Butcher|Butchers|a Butcher|
Candlestick Maker|Candlestick Makers|a Candlestick Maker|
Doctor|Doctors|a Doctor|
Herald|Heralds|a Herald|
Journeyman|Journeymen|a Journeyman|
Masterpiece|Masterpieces|a Masterpiece|
Merchant Guild|Merchant Guilds|a Merchant Guild|
Plaza|Plazas|a Plaza|
Taxman|Taxmen|a Taxman|
Soothsayer|Soothsayers|a Soothsayer|
Stonemason|Stonemasons|a Stonemason|
Alms|Alms|an Alms|
Amulet|Amulets|an Amulet|
Artificer|Artificers|an Artificer|
Ball|Balls|a Ball|
Bonfire|Bonfires|a Bonfire|
Borrow|Borrows|a Borrow|
Bridge Troll|Bridge Trolls|a Bridge Troll|
Caravan Guard|Caravan Guards|a Caravan Guard|
Champion|Champions|a Champion|
Coin of the Realm|Coins of the Realm|a Coin of the Realm|
Disciple|Disciples|a Disciple|
Distant Lands|Distant Lands|a Distant Lands|
Dungeon|Dungeons|a Dungeon|
Duplicate|Duplicates|a Duplicate|
Expedition|Expeditions|an Expedition|
Ferry|Ferries|a Ferry|
Fugitive|Fugitives|a Fugitive|
Gear|Gears|a Gear|
Giant|Giants|a Giant|
Guide|Guides|a Guide|
Haunted Woods|Haunted Woods|a Haunted Woods|
Hero|Heroes|a Hero|
Hireling|Hirelings|a Hireling|
Inheritance|Inheritances|an Inheritance|
Lost Arts|Lost Arts|a Lost Arts|
Lost City|Lost Cities|a Lost City|
Magpie|Magpies|a Magpie|
Messenger|Messengers|a Messenger|
Miser|Misers|a Miser|
Mission|Missions|a Mission|
Pathfinding|Pathfindings|a Pathfinding|
Page|Pages|a Page|
Peasant|Peasants|a Peasant|
Pilgrimage|Pilgrimages|a Pilgrimage|
Plan|Plans|a Plan|
Port|Ports|a Port|
Quest|Quests|a Quest|
Ranger|Rangers|a Ranger|
Raid|Raids|a Raid|
Ratcatcher|Ratcatchers|a Ratcatcher|
Raze|Razes|a Raze|
Relic|Relics|a Relic|
Royal Carriage|Royal Carriages|a Royal Carriage|
Save|Saves|a Save|
Scouting Party|Scouting Parties|a Scouting Party|
Seaway|Seaways|a Seaway|
Soldier|Soldiers|a Soldier|
Storyteller|Storytellers|a Storyteller|
Swamp Hag|Swamp Hags|a Swamp Hag|
Teacher|Teachers|a Teacher|
Travelling Fair|Travelling Fairs|a Travelling Fair|
Trade|Trades|a Trade|
Training|Trainings|a Training|
Transmogrify|Transmogrifies|a Transmogrify|
Treasure Trove|Treasure Troves|a Treasure Trove|
Treasure Hunter|Treasure Hunters|a Treasure Hunter|
Warrior|Warriors|a Warrior|
Wine Merchant|Wine Merchants|a Wine Merchant|
Encampment|Encampments|an Encampment|
Plunder|Plunders|a Plunder|
Patrician|Patricians|a Patrician|
Emporium|Emporia|an Emporium|
Settlers|Settlers|a Settlers|
Bustling Village|Bustling Villages|a Bustling Village|
Catapult|Catapults|a Catapult|
Rocks|Rocks|a Rocks|
Gladiator|Gladiators|a Gladiator|
Fortune|Fortunes|a Fortune|
Castles|Castles|a Castles|
Humble Castle|Humble Castles|a Humble Castle|
Crumbling Castle|Crumbling Castles|a Crumbling Castle|
Small Castle|Small Castles|a Small Castle|
Haunted Castle|Haunted Castles|a Haunted Castle|
Opulent Castle|Opulent Castles|an Opulent Castle|
Sprawling Castle|Sprawling Castles|a Sprawling Castle|
Grand Castle|Grand Castles|a Grand Castle|
King's Castle|King's Castles|a King's Castle|
Advance|Advances|an Advance|
Annex|Annexes|an Annex|
Archive|Archives|an Archive|
Aqueduct|Aqueducts|an Aqueduct|
Arena|Arenas|an Arena|
Bandit Fort|Bandit Forts|a Bandit Fort|
Banquet|Banquets|a Banquet|
Basilica|Basilicas|a Basilica|
Baths|Baths|a Baths|
Battlefield|Battlefields|a Battlefield|
Capital|Capitals|a Capital|
Charm|Charms|a Charm|
Chariot Race|Chariot Races|a Chariot Race|
City Quarter|City Quarters|a City Quarter|
Colonnade|Colonnades|a Colonnade|
Conquest|Conquests|a Conquest|
Crown|Crowns|a Crown|
Delve|Delves|a Delve|
Defiled Shrine|Defiled Shrines|a Defiled Shrine|
Dominate|Dominates|a Dominate|
Donate|Donates|a Donate|
Enchantress|Enchantresses|an Enchantress|
Engineer|Engineers|an Engineer|
Farmers' Market|Farmers' Markets|a Farmers' Market|
Forum|Forums|a Forum|
Fountain|Fountains|a Fountain|
Groundskeeper|Groundskeepers|a Groundskeeper|
Keep|Keeps|a Keep|
Labyrinth|Labyrinths|a Labyrinth|
Legionary|Legionaries|a Legionary|
Mountain Pass|Mountain Passes|a Mountain Pass|
Museum|Museums|a Museum|
Obelisk|Obelisks|an Obelisk|
Orchard|Orchards|an Orchard|
Overlord|Overlords|an Overlord|
Palace|Palaces|a Palace|
Ritual|Rituals|a Ritual|
Royal Blacksmith|Royal Blacksmiths|a Royal Blacksmith|
Sacrifice|Sacrifices|a Sacrifice|
Salt the Earth|Salt the Earths|a Salt the Earth|
Tax|Taxes|a Tax|
Temple|Temples|a Temple|
Tomb|Tombs|a Tomb|
Tower|Towers|a Tower|
Triumph|Triumphs|a Triumph|
Triumphal Arch|Triumphal Arches|a Triumphal Arch|
Villa|Villas|a Villa|
Wall|Walls|a Wall|
Wolf Den|Wolf Dens|a Wolf Den|
Wedding|Weddings|a Wedding|
Wild Hunt|Wild Hunts|a Wild Hunt|
Windfall|Windfalls|a Windfall|
Pig|Pig|Pig|
MinusCard|MinusCard|MinusCard|
MinusCoin|MinusCoin|MinusCoin|
State Limbo|State Limbo|State Limbo|
Druid Boons|Druid Boons|Druid Boons|
Boon Drawpile|Boon Drawpiles|a Boon Drawpile|
Boon Discardpile|Boon Discardpiles|a Boon Discardpile|
The Earth's Gift|The Earth's Gifts|The Earth's Gift|
The Field's Gift|The Field's Gifts|The Field's Gift|
The Flame's Gift|The Flame's Gifts|The Flame's Gift|
The Forest's Gift|The Forest's Gifts|The Forest's Gift|
The Moon's Gift|The Moon's Gifts|The Moon's Gift|
The Mountain's Gift|The Mountain's Gifts|The Mountain's Gift|
The River's Gift|The River's Gifts|The River's Gift|
The Sea's Gift|The Sea's Gifts|The Sea's Gift|
The Sky's Gift|The Sky's Gifts|The Sky's Gift|
The Sun's Gift|The Sun's Gifts|The Sun's Gift|
The Swamp's Gift|The Swamp's Gifts|The Swamp's Gift|
The Wind's Gift|The Wind's Gifts|The Wind's Gift|
Hex Drawpile|Hex Drawpiles|a Hex Drawpile|
Hex Discardpile|Hex Discardpiles|a Hex Discardpile|
Bad Omens|Bad Omens|Bad Omens|
Delusion|Delusions|Delusion|
Envy|Envies|Envy|
Famine|Famines|Famine|
Fear|Fears|Fear|
Greed|Greeds|Greed|
Haunting|Hauntings|Haunting|
Locusts|Locusts|Locusts|
Misery|Miseries|Misery|
Plague|Plagues|Plague|
Poverty|Poverties|Poverty|
War|Wars|War|
Miserable|Miserables|Miserable|
Twice Miserable|Twice Miserables|Twice Miserable|
Envious|Envious|Envious|
Deluded|Deludeds|Deluded|
Lost In The Woods|Lost In The Woods|Lost In The Woods|
Bard|Bards|a Bard|
Blessed Village|Blessed Villages|a Blessed Village|
Changeling|Changelings|a Changeling|
Cemetery|Cemeteries|a Cemetery|
Cobbler|Cobblers|a Cobbler|
Conclave|Conclaves|a Conclave|
Crypt|Crypts|a Crypt|
Cursed Village|Cursed Villages|a Cursed Village|
Den of Sin|Dens of Sin|a Den of Sin|
Devil's Workshop|Devil's Workshops|a Devil's Workshop|
Druid|Druids|a Druid|
Exorcist|Exorcists|an Exorcist|
Faithful Hound|Faithful Hounds|a Faithful Hound|
Fool|Fools|a Fool|
Ghost Town|Ghost Towns|a Ghost Town|
Guardian|Guardians|a Guardian|
Idol|Idols|an Idol|
Leprechaun|Leprechauns|a Leprechaun|
Monastery|Monasteries|a Monastery|
Necromancer|Necromancers|a Necromancer|
Night Watchman|Night Watchmen|a Night Watchman|
Pixie|Pixies|a Pixie|
Pooka|Pookas|a Pooka|
Raider|Raiders|a Raider|
Sacred Grove|Sacred Groves|a Sacred Grove|
Secret Cave|Secret Caves|a Secret Cave|
Shepherd|Shepherds|a Shepherd|
Skulk|Skulks|a Skulk|
Tormentor|Tormentors|a Tormentor|
Tragic Hero|Tragic Heroes|a Tragic Hero|
Tracker|Trackers|a Tracker|
Vampire|Vampires|a Vampire|
Werewolf|Werewolves|a Werewolf|
Cursed Gold|Cursed Golds|a Cursed Gold|
Goat|Goats|a Goat|
Haunted Mirror|Haunted Mirrors|a Haunted Mirror|
Lucky Coin|Lucky Coins|a Lucky Coin|
Magic Lamp|Magic Lamps|a Magic Lamp|
Pasture|Pastures|a Pasture|
Pouch|Pouches|a Pouch|
Bat|Bats|a Bat|
Ghost|Ghosts|a Ghost|
Imp|Imps|an Imp|
Will-o'-Wisp|Will-o'-Wisps|a Will-o'-Wisp|
Wish|Wishes|a Wish|
Zombie Apprentice|Zombie Apprentices|a Zombie Apprentice|
Zombie Mason|Zombie Masons|a Zombie Mason|
Zombie Spy|Zombie Spies|a Zombie Spy|
Acting Troupe|Acting Troupes|an Acting Troupe|
Border Guard|Border Guards|a Border Guard|
Cargo Ship|Cargo Ships|a Cargo Ship|
Ducat|Ducats|a Ducat|
Experiment|Experiments|an Experiment|
Flag Bearer|Flag Bearers|a Flag Bearer|
Hideout|Hideouts|a Hideout|
Inventor|Inventors|an Inventor|
Improve|Improves|an Improve|
Lackeys|Lackeys|a Lackeys|
Mountain Village|Mountain Villages|a Mountain Village|
Patron|Patrons|a Patron|
Priest|Priests|a Priest|
Research|Researches|a Research|
Silk Merchant|Silk Merchants|a Silk Merchant|
Old Witch|Old Witches|an Old Witch|
Recruiter|Recruiters|a Recruiter|
Scepter|Scepters|a Scepter|
Scholar|Scholars|a Scholar|
Sculptor|Sculptors|a Sculptor|
Seer|Seers|a Seer|
Spices|Spices|a Spices|
Swashbuckler|Swashbucklers|a Swashbuckler|
Treasurer|Treasurers|a Treasurer|
Villain|Villains|a Villain|
Flag|Flags|the Flag|
Horn|Horns|the Horn|
Key|Keys|the Key|
Lantern|Lanterns|the Lantern|
Treasure Chest|Treasure Chests|the Treasure Chest|
Academy|Academy|Academy|
Barracks|Barracks|Barracks|
Canal|Canal|Canal|
Capitalism|Capitalism|Capitalism|
Cathedral|Cathedral|Cathedral|
Citadel|Citadel|Citadel|
City Gate|City Gate|City Gate|
Crop Rotation|Crop Rotation|Crop Rotation|
Exploration|Exploration|Exploration|
Fair|Fair|Fair|
Fleet|Fleet|Fleet|
Guildhall|Guildhall|Guildhall|
Innovation|Innovation|Innovation|
Pageant|Pageant|Pageant|
Piazza|Piazza|Piazza|
Road Network|Road Network|Road Network|
Sewers|Sewers|Sewers|
Silos|Silos|Silos|
Sinister Plot|Sinister Plot|Sinister Plot|
Star Chart|Star Chart|Star Chart|
Sauna|Saunas|a Sauna|
Avanto|Avantos|an Avanto|
Black Market|Black Markets|a Black Market|
Envoy|Envoys|an Envoy|
Governor|Governors|a Governor|
Prince|Princes|a Prince|
Stash|Stashes|a Stash|
Summon|Summons|a Summon|
Walled Village|Walled Villages|a Walled Village|
Black Market Deck|Black Market Decks|a Black Market Deck|
Dismantle|Dismantles|a Dismantle|
Captain|Captains|a Captain|
Church|Churches|a Church|
Black Cat|Black Cats|a Black Cat|
Sleigh|Sleighs|a Sleigh|
Supplies|Supplies|a Supplies|
Camel Train|Camel Trains|a Camel Train|
Goatherd|Goatherds|a Goatherd|
Scrap|Scraps|a Scrap|
Sheepdog|Sheepdogs|a Sheepdog|
Snowy Village|Snowy Villages|a Snowy Village|
Stockpile|Stockpiles|a Stockpile|
Bounty Hunter|Bounty Hunters|a Bounty Hunter|
Cardinal|Cardinals|a Cardinal|
Cavalry|Cavalries|a Cavalry|
Groom|Grooms|a Groom|
Hostelry|Hostelries|a Hostelry|
Village Green|Village Greens|a Village Green|
Barge|Barges|a Barge|
Coven|Covens|a Coven|
Displace|Displaces|a Displace|
Falconer|Falconers|a Falconer|
Fisherman|Fishermen|a Fisherman|
Gatekeeper|Gatekeepers|a Gatekeeper|
Hunting Lodge|Hunting Lodges|a Hunting Lodge|
Kiln|Kilns|a Kiln|
Livery|Liveries|a Livery|
Mastermind|Masterminds|a Mastermind|
Paddock|Paddocks|a Paddock|
Sanctuary|Sanctuaries|a Sanctuary|
Destrier|Destriers|a Destrier|
Wayfarer|Wayfarers|a Wayfarer|
Animal Fair|Animal Fairs|an Animal Fair|
Horse|Horses|a Horse|
Way of the Butterfly|Way of the Butterfly|Way of the Butterfly|
Way of the Camel|Way of the Camel|Way of the Camel|
Way of the Chameleon|Way of the Chameleon|Way of the Chameleon|
Way of the Frog|Way of the Frog|Way of the Frog|
Way of the Goat|Way of the Goat|Way of the Goat|
Way of the Horse|Way of the Horse|Way of the Horse|
Way of the Mole|Way of the Mole|Way of the Mole|
Way of the Monkey|Way of the Monkey|Way of the Monkey|
Way of the Mouse|Way of the Mouse|Way of the Mouse|
Way of the Mule|Way of the Mule|Way of the Mule|
Way of the Otter|Way of the Otter|Way of the Otter|
Way of the Owl|Way of the Owl|Way of the Owl|
Way of the Ox|Way of the Ox|Way of the Ox|
Way of the Pig|Way of the Pig|Way of the Pig|
Way of the Rat|Way of the Rat|Way of the Rat|
Way of the Seal|Way of the Seal|Way of the Seal|
Way of the Sheep|Way of the Sheep|Way of the Sheep|
Way of the Squirrel|Way of the Squirrel|Way of the Squirrel|
Way of the Turtle|Way of the Turtle|Way of the Turtle|
Way of the Worm|Way of the Worm|Way of the Worm|
Delay|Delay|Delay|
Desperation|Desperation|Desperation|
Gamble|Gamble|Gamble|
Pursue|Pursue|Pursue|
Ride|Ride|Ride|
Toil|Toil|Toil|
Enhance|Enhance|Enhance|
March|March|March|
Transport|Transport|Transport|
Banish|Banish|Banish|
Bargain|Bargain|Bargain|
Invest|Invest|Invest|
Seize The Day|Seize The Day|Seize The Day|
Commerce|Commerce|Commerce|
Demand|Demand|Demand|
Stampede|Stampede|Stampede|
Reap|Reap|Reap|
Enclave|Enclave|Enclave|
Alliance|Alliance|Alliance|
Populate|Populate|Populate|
Card Of The Butterfly|Card Of The Butterfly|Card Of The Butterfly|
Card Of The Camel|Card Of The Camel|Card Of The Camel|
Card Of The Chameleon|Card Of The Chameleon|Card Of The Chameleon|
Card Of The Frog|Card Of The Frog|Card Of The Frog|
Card Of The Goat|Card Of The Goat|Card Of The Goat|
Card Of The Horse|Card Of The Horse|Card Of The Horse|
Card Of The Mole|Card Of The Mole|Card Of The Mole|
Card Of The Monkey|Card Of The Monkey|Card Of The Monkey|
Card Of The Mouse|Card Of The Mouse|Card Of The Mouse|
Card Of The Mule|Card Of The Mule|Card Of The Mule|
Card Of The Otter|Card Of The Otter|Card Of The Otter|
Card Of The Owl|Card Of The Owl|Card Of The Owl|
Card Of The Ox|Card Of The Ox|Card Of The Ox|
Card Of The Pig|Card Of The Pig|Card Of The Pig|
Card Of The Rat|Card Of The Rat|Card Of The Rat|
Card Of The Seal|Card Of The Seal|Card Of The Seal|
Card Of The Sheep|Card Of The Sheep|Card Of The Sheep|
Card Of The Squirrel|Card Of The Squirrel|Card Of The Squirrel|
Card Of The Turtle|Card Of The Turtle|Card Of The Turtle|
Card Of The Worm|Card Of The Worm|Card Of The Worm|